17 17 17 17 17 17 17 17 17 5 5 5 17 17 17 17 17 17
17 0 0 0 0 0 0 0 0 0 0 0 0 0 0 17 0 0 17
17 0 0 0 0 0 0 0 0 0 0 0 0 0 0 17 0 0 17
17 0 0 0 0 0 0 0 0 0 0 0 0 0 0 17 17 17 17
17 0 0 0 0 0 0 0 0 0 0 0 0 0 0 4 5 0 17
17 0 0 0 0 0 0 0 0 0 0 0 0 0 0 4 5 0 17
17 0 0 0 0 0 0 0 0 0 0 0 0 0 0 4 5 0 17
17 0 0 0 0 0 0 0 0 0 0 0 0 0 0 17 17 17 17
17 0 0 0 0 0 0 0 0 0 0 0 0 0 0 17 0 0 17
17 0 0 0 0 0 0 0 0 0 0 0 0 0 0 17 0 0 17
17 0 0 0 0 0 0 0 0 0 0 0 0 0 0 17 0 0 17
17 17 17 17 17 17 17 17 17 17 17 17 17 17 17 17 17 17